.,.,.,.,.,.,.,.,.,.,.,.,.,.,.,.,.,.,.,.,.,.,.,.,.,
.,#,#,#,#,#,#,#,.,.,.,.,.,.,.,#,#,#,#,#,#,#,#,#,.,
.,#,.,.,.,.,.,#,.,#,#,#,#,#,.,#,.,.,.,.,.,.,.,#,.,
.,#,.,.,.,.,.,#,.,#,.,.,.,#,.,#,.,.,.,.,.,*,.,#,.,
.,#,.,#,.,#,.,#,#,#,.,X,.,#,.,#,.,.,.,.,.,.,.,#,.,
.,#,.,.,.,.,.,.,.,.,.,.,.,#,.,#,#,.,#,#,#,#,#,#,.,
.,#,.,.,.,.,.,.,.,.,.,.,.,#,.,.,#,.,#,.,.,.,.,.,.,
.,#,.,.,@,.,.,K,.,.,.,.,#,#,.,#,#,D,#,#,#,.,.,.,.,
.,#,.,.,.,.,.,.,.,.,.,.,#,.,.,#,.,.,.,.,#,.,.,.,.,
.,#,.,.,.,.,.,#,#,#,#,.,#,#,#,#,.,.,.,.,#,.,.,.,.,
.,#,.,#,.,#,.,#,.,.,#,.,.,.,.,.,!,.,.,.,#,.,.,.,.,
.,#,.,.,.,.,.,#,.,.,#,.,.,.,.,.,!,.,.,.,#,.,.,.,.,
.,#,.,.,.,.,.,#,.,.,#,.,.,#,#,#,.,.,.,.,#,.,.,.,.,
.,#,#,#,#,#,#,#,.,.,#,#,#,#,.,#,#,#,#,#,#,.,.,.,.,
.,.,.,.,.,.,.,.,.,.,.,.,.,.,.,.,.,.,.,.,.,.,.,.,.,
